//MAP CONVERTED BY dmm2tgm.py THIS HEADER COMMENT PREVENTS RECONVERSION, DO NOT REMOVE
"aa" = (
/obj/machinery/door/blast/regular{
	density = 0;
	icon_state = "pdoor0";
	id = "EngineRadiatorViewport";
	name = "Engine Radiator Viewport Shutter";
	opacity = 0
	},
/turf/simulated/floor/tiled/techfloor/grid,
/area/engineering/engine_room)
"ab" = (
/obj/machinery/door/blast/regular{
	density = 0;
	icon_state = "pdoor0";
	id = "EngineRadiatorViewport";
	name = "Engine Radiator Viewport Shutter";
	opacity = 0
	},
/obj/machinery/atmospherics/pipe/simple/visible/black{
	dir = 4
	},
/turf/simulated/floor/tiled/techfloor/grid,
/area/engineering/engine_room)
"bb" = (
/obj/effect/wingrille_spawn/reinforced_phoron,
/obj/machinery/door/blast/regular{
	dir = 4;
	id = "SupermatterPort";
	layer = 3.3;
	name = "Reactor Blast Door"
	},
/turf/simulated/floor,
/area/engineering/engine_room)
"dF" = (
/obj/machinery/door/blast/regular{
	dir = 4;
	icon_state = "pdoor1";
	id = "EngineVent";
	name = "Reactor Vent";
	p_open = 0
	},
/turf/simulated/floor/reinforced/nitrogen,
/area/engineering/engine_room)
"eK" = (
/obj/machinery/air_sensor{
	frequency = 1438;
	id_tag = "engine_sensor";
	output = 63
	},
/obj/effect/floor_decal/industrial/warning{
	dir = 5
	},
/obj/effect/floor_decal/industrial/warning/corner{
	dir = 8
	},
/turf/simulated/floor/reinforced/nitrogen{
	nitrogen = 82.1472
	},
/area/engineering/engine_room)
"gS" = (
/obj/machinery/atmospherics/unary/outlet_injector{
	dir = 4;
	frequency = 1438;
	id = "cooling_in";
	name = "Coolant Injector";
	pixel_y = 1;
	power_rating = 30000;
	use_power = 1;
	volume_rate = 700
	},
/obj/effect/floor_decal/industrial/warning{
	dir = 6
	},
/obj/effect/floor_decal/industrial/warning/corner{
	dir = 1;
	icon_state = "warningcorner"
	},
/turf/simulated/floor/reinforced/nitrogen{
	nitrogen = 82.1472
	},
/area/engineering/engine_room)
"hJ" = (
/obj/structure/sign/vacuum,
/turf/simulated/wall/r_wall,
/area/engineering/engine_room)
"kP" = (
/obj/effect/floor_decal/steeldecal/steel_decals_central4{
	dir = 8
	},
/turf/simulated/floor/tiled/monotile,
/area/engineering/engine_room)
"mp" = (
/obj/machinery/meter,
/obj/machinery/atmospherics/pipe/simple/visible/yellow{
	dir = 10
	},
/turf/simulated/floor/tiled/monotile,
/area/engineering/engine_room)
"mL" = (
/turf/template_noop,
/area/engineering/engine_room)
"oR" = (
/obj/machinery/power/supermatter{
	layer = 4
	},
/obj/machinery/mass_driver{
	dir = 8;
	id = "enginecore"
	},
/turf/simulated/floor/greengrid/nitrogen,
/area/engineering/engine_room)
"qc" = (
/obj/machinery/shield_diffuser,
/obj/machinery/atmospherics/unary/outlet_injector{
	dir = 4;
	frequency = 1439;
	id = "waste_out";
	name = "Waste Ejector";
	pixel_y = 1;
	power_rating = 30000;
	use_power = 1;
	volume_rate = 700
	},
/turf/simulated/floor/airless,
/area/engineering/engine_room)
"sv" = (
/obj/machinery/button/remote/blast_door{
	desc = "A remote control-switch for the engine radiator viewport shutters.";
	dir = 4;
	id = "EngineRadiatorViewport";
	name = "Engine Radiator Viewport Shutters";
	pixel_x = -25;
	pixel_y = 0;
	req_access = list(10)
	},
/turf/simulated/floor/plating,
/area/engineering/engine_room)
"td" = (
/turf/template_noop,
/area/template_noop)
"zU" = (
/obj/machinery/atmospherics/pipe/simple/visible/yellow{
	dir = 4
	},
/obj/effect/wingrille_spawn/reinforced_phoron,
/obj/machinery/door/blast/regular{
	dir = 4;
	id = "SupermatterPort";
	layer = 3.3;
	name = "Reactor Blast Door"
	},
/turf/simulated/floor,
/area/engineering/engine_room)
"Bo" = (
/obj/machinery/light{
	dir = 1
	},
/turf/simulated/floor/plating,
/area/engineering/engine_room)
"Cu" = (
/obj/machinery/light,
/turf/simulated/floor/plating,
/area/engineering/engine_room)
"Df" = (
/obj/effect/floor_decal/industrial/warning{
	dir = 1
	},
/obj/effect/floor_decal/industrial/warning,
/turf/simulated/floor/reinforced/nitrogen{
	nitrogen = 82.1472
	},
/area/engineering/engine_room)
"DC" = (
/obj/machinery/power/emitter{
	anchored = 1;
	dir = 8;
	id = "EngineEmitter";
	pixel_y = 8;
	state = 2
	},
/obj/structure/cable/cyan{
	d1 = 0;
	d2 = 4;
	icon_state = "0-4"
	},
/obj/effect/floor_decal/steeldecal/steel_decals6{
	dir = 6
	},
/obj/effect/floor_decal/steeldecal/steel_decals6{
	dir = 10
	},
/obj/effect/floor_decal/steeldecal/steel_decals6{
	dir = 9
	},
/obj/effect/floor_decal/steeldecal/steel_decals6{
	dir = 5
	},
/turf/simulated/floor/tiled/monotile,
/area/engineering/engine_room)
"FN" = (
/turf/simulated/floor/plating,
/area/engineering/engine_room)
"FO" = (
/obj/machinery/door/airlock/hatch{
	icon_state = "door_locked";
	id_tag = "engine_access_hatch";
	locked = 1;
	req_access = list(11)
	},
/turf/simulated/floor/reinforced,
/area/engineering/engine_room)
"Jb" = (
/turf/simulated/floor/tiled/monotile,
/area/engineering/engine_room)
"Jo" = (
/turf/simulated/floor,
/area/engineering/engine_room)
"Lo" = (
/obj/machinery/atmospherics/unary/vent_pump/engine{
	dir = 1;
	external_pressure_bound = 100;
	external_pressure_bound_default = 0;
	frequency = 1438;
	icon_state = "map_vent_in";
	id_tag = "cooling_out";
	initialize_directions = 4;
	pump_direction = 0;
	use_power = 1
	},
/obj/effect/floor_decal/industrial/warning/cee{
	dir = 8
	},
/turf/simulated/floor/reinforced/nitrogen{
	nitrogen = 82.1472
	},
/area/engineering/engine_room)
"LR" = (
/obj/effect/floor_decal/industrial/warning{
	dir = 8
	},
/obj/effect/floor_decal/industrial/warning{
	dir = 4;
	icon_state = "warning"
	},
/turf/simulated/floor/reinforced/nitrogen{
	nitrogen = 82.1472
	},
/area/engineering/engine_room)
"Oz" = (
/obj/effect/wingrille_spawn/reinforced_phoron,
/obj/machinery/door/blast/regular{
	dir = 2;
	id = "SupermatterPort";
	layer = 3.3;
	name = "Reactor Blast Door"
	},
/turf/simulated/floor,
/area/engineering/engine_room)
"OV" = (
/turf/simulated/floor/greengrid/nitrogen,
/area/engineering/engine_room)
"Pw" = (
/obj/machinery/atmospherics/pipe/simple/visible/red,
/obj/effect/wingrille_spawn/reinforced_phoron,
/obj/machinery/door/blast/regular{
	dir = 2;
	id = "SupermatterPort";
	layer = 3.3;
	name = "Reactor Blast Door"
	},
/turf/simulated/floor,
/area/engineering/engine_room)
"SS" = (
/obj/machinery/atmospherics/pipe/simple/visible/red{
	dir = 6
	},
/obj/machinery/camera/network/engine{
	dir = 4
	},
/turf/simulated/floor/plating,
/area/engineering/engine_room)
"TB" = (
/obj/machinery/button/remote/blast_door{
	desc = "A remote control-switch for the engine charging port.";
	id = "SupermatterPort";
	name = "Reactor Blast Doors";
	pixel_x = -25;
	pixel_y = -5;
	req_access = list(10)
	},
/obj/machinery/button/remote/blast_door{
	desc = "A remote control-switch for the engine control room blast doors.";
	id = "EngineBlast";
	name = "Engine Monitoring Room Blast Doors";
	pixel_x = -25;
	pixel_y = 5;
	req_access = list(10)
	},
/turf/simulated/floor/plating,
/area/engineering/engine_room)
"WZ" = (
/turf/simulated/wall/r_wall,
/area/engineering/engine_room)
"XY" = (
/obj/effect/floor_decal/industrial/warning/cee{
	dir = 8
	},
/obj/machinery/camera/network/engine{
	dir = 4
	},
/turf/simulated/floor/reinforced/nitrogen{
	nitrogen = 82.1472
	},
/area/engineering/engine_room)
"Za" = (
/turf/template_noop,
/area/space)

(1,1,1) = {"
Za
Za
Za
Za
Za
WZ
WZ
WZ
hJ
dF
hJ
WZ
WZ
WZ
Za
Za
Za
Za
Za
"}
(2,1,1) = {"
Za
Za
Za
Za
Za
WZ
SS
Pw
Lo
OV
XY
Oz
FN
WZ
Za
Za
Za
Za
Za
"}
(3,1,1) = {"
Za
Za
Za
Za
Za
WZ
Bo
Oz
Df
oR
Df
Oz
Cu
WZ
Za
qc
Za
Za
Za
"}
(4,1,1) = {"
WZ
aa
aa
aa
WZ
WZ
FN
Oz
eK
LR
gS
Oz
FN
WZ
aa
ab
aa
WZ
WZ
"}
(5,1,1) = {"
WZ
FN
FN
FN
FN
sv
FN
WZ
FO
bb
zU
WZ
FN
FN
FN
FN
FN
FN
WZ
"}
(6,1,1) = {"
WZ
FN
FN
FN
FN
FN
FN
TB
Jb
kP
mp
FN
FN
FN
FN
FN
FN
FN
WZ
"}
(7,1,1) = {"
WZ
FN
FN
FN
FN
FN
FN
FN
FN
DC
FN
FN
FN
FN
FN
FN
FN
FN
WZ
"}
(8,1,1) = {"
WZ
FN
FN
FN
FN
FN
FN
FN
FN
Jo
FN
FN
FN
FN
FN
FN
FN
FN
WZ
"}
(9,1,1) = {"
WZ
FN
FN
FN
FN
FN
FN
FN
FN
FN
FN
FN
FN
FN
FN
FN
FN
FN
WZ
"}
(10,1,1) = {"
WZ
FN
FN
FN
FN
FN
FN
FN
FN
FN
FN
FN
FN
FN
FN
FN
FN
FN
WZ
"}
(11,1,1) = {"
WZ
FN
FN
FN
FN
FN
FN
FN
FN
FN
FN
FN
FN
FN
FN
FN
FN
FN
WZ
"}
(12,1,1) = {"
WZ
FN
FN
FN
FN
FN
FN
FN
FN
FN
FN
FN
FN
FN
td
td
td
FN
WZ
"}
(13,1,1) = {"
WZ
FN
FN
FN
FN
FN
FN
FN
FN
FN
FN
WZ
WZ
WZ
td
td
td
WZ
WZ
"}
(14,1,1) = {"
WZ
FN
FN
FN
FN
FN
FN
FN
FN
FN
FN
WZ
td
td
td
td
td
td
td
"}
(15,1,1) = {"
WZ
FN
FN
FN
FN
FN
FN
FN
FN
FN
FN
WZ
td
td
td
td
td
td
td
"}
(16,1,1) = {"
WZ
FN
FN
FN
FN
FN
FN
FN
FN
FN
FN
WZ
td
td
td
td
td
td
td
"}
(17,1,1) = {"
WZ
FN
FN
FN
FN
FN
FN
FN
FN
FN
FN
WZ
td
td
td
td
td
td
td
"}
(18,1,1) = {"
WZ
FN
FN
FN
FN
FN
FN
FN
FN
FN
FN
WZ
td
td
td
td
td
td
td
"}
(19,1,1) = {"
WZ
WZ
WZ
WZ
WZ
mL
WZ
WZ
WZ
WZ
WZ
WZ
td
td
td
td
td
td
td
"}
